11111111111111111111111
10000000000000000000001
10000000000000000000001
1P000000000000000000001
10000000000000000000001
10000000000000000000001
10000000001000000000001
10000000000000000000001
1000C00000000000000E001
11111111111111111111111