11111111111111111111111
1C100000001110000000001
10100000001010000000001
1P000000001010000000001
10000000000000000000001
10000000000000000000001
10000000001000000000001
100000000C00000000001C1
1000C0000000000000001E1
11111111111111111111111