11111111111111111111111
1C100000001110000000001
10100000000E10000000001
1P000000001110000000001
10000000000000000000001
10000000000000000000001
10000000001000000000001
100000000C0000000000001
1000C000000000000000001
11111111111111111111111