11111111111111111111111
100000000P0000000000001
100000000C0000000000001
1000000C000000000000001
1000000C000000000000010
100000000C0000000000011
10000000000000000000001
1000000000C0000000E0001
11111111111111111111111