11111111111111111111111
1C100000001110000000001
10100000001010000000001
10000000001010000000001
10000000000000000000001
10000000000000000000001
10000000001000000000001
100P00000C00000000001E1
1000C000000000000000101
11111111111111111111111