111111111111111111111111111111
1C11C00100000000C00000000000C1
1C111001000000C1C0001111111111
10100001C010011111000000000011
100000010010000C00000000000001
100000010C10000000111110000001
100100011110000000100100000001
100100000000000001100111110001
100100000000010011110000000001
100100000000010011111100000001
1001001110000100CC000111111001
1001C00C1011100001100000001001
100111111000100001000000001001
11C100110000CC0001000111111001
111100110000100001000001000001
1C0100000000100001000001000001
100100001111111111111111100001
100100000100000100000000000001
10000011000000110000C000C00101
10001011001100CC11111100111101
1001C00C1011100001100000001001
100111111000100001000000001001
100100000100000100000000000001
10000011000000110000C000C00101
10001111001100CC11111111111101
1P100C110011000000000C000001E1
111111111111111111111111111111